NO ./textures/4.xpm




F 255,255,255





EA ./textures/1.xpm















C 128,128,255








SO ./textures/6.xpm


















WE ./textures/7.xpm





        1111111111111111111111111
        100000000110000000000001
        1011000001110000000000001
        1001000000000000000000001
11111111101100001110000000000001
100000000011000001110111111111111
11110111111111011100000010001
1111011111111101110110010001
1111100000011010101110000S011
1001000000000000110000001000111111111111111111111111111111111111
10000000000000001101010010000000000000000000000000000000000000001
1100000111010101111101111001111111111111111111111111111111111111
11100111 1110101 10111110001
11101111 1111111 111111111111





1110111
1000001
1111111