NO ./texts/4.xpm
EA ./texts/1.xpm
SO ./texts/6.xpm
WE ./texts/7.xpm
C 128,128,128
F 255,255,255


111111111111111111111111111111111111111111111111111111111111
10W000000000000000000000000000000000000000000000000000000001
111111111111111111111111111111111110111111111111111111111111
111111111111111111111111111111111110111111111111111111111111
1111111111111111111111111111111111101111111111111111111111
10000000000000000000000000000000000000000000000000000000001
10000000000000000000000000000000000000000000000000000000001
10000000000000000000000000000000000000000000000000000000001
111111111111111111111111111111111111111111111111111111111111
